6 24
1 2 2 2 2 2 1 1 1 2 2 2 2 2 1 1 1 1 1 1 4 5 6 7
8 8 8 8 8 8 9 9 8 8 8 8 8 8 9 9 9 9 9 9 19 12 13 14
8 16 8 8 8 8 8 8 8 16 8 8 8 8 8 8 8 8 16 16 18 19 20 21
16 23 16 16 16 16 16 16 16 23 16 16 16 16 16 16 16 16 23 22 25 26 27 28
24 30 17 24 24 17 24 17 24 30 17 24 24 17 24 17 17 29 30 31 32 33 34 35
36 36 36 36 36 36 36 36 36 36 36 36 36 36 36 36 36 36 36 36 36 36 36 36